0000000000000000000
0000000000000001000
0000000000100010000
0001011210001001000
0010000110101100000
0000000100010010110
0010110001000000010
0000000100010100000
0000000010000000100
0000001000000000000
0000100010001000000
0000000000000001000
0000000010000000000
0001000000001000000
0000011000001000001
0000000010000000000
0000000000100001010
0001101000011000000
0010000100010000000
0000100100101100000
0000000000000000010
0100100001000000000
0000003010000000000
0010000001000000100
0000000010010010000
0000100000000000000
0000000100000000000
0000000000000000000
